################################
#                              #
#F                           % #
###                            #
#  #K                          #
#   #                        @ #
#     K  K  K  K  K  K       # #
#     #  #  #  #  #  %         #
#                              #
#                       #      #
#                              #
#                     #        #
#                              #
#                   #          #
#                              #
#                 #       P    #
#                         I    #
#               #         #    #
#                              #
#             #         P      #
#                       I      #
#           #           #      #
#                              #
#         #            P P P P #
#                      I I I I #
#       #              # # # # #
#                              #
#^    #               P P P P P#
#                     I I I I I#
#   #                 # # # # ##
#                              #
################################
